01111111111111111111
00000200301105200301
00111101101101101101
15200300000000000021
10110111151110111011
10010020000000200101
11110111101101101111
10003010021001100001
10111011101511001101
10200003002000005021
10100110001110101011
10300000100050003031
10111151001101101101
10200003004000500021
11111111111111111111
