01111111111111111111
00502000000000105001
00101100101040112011
10301200101200100011
10101110101100101101
10250000020000000021
10101100101100101001
10003200010000305001
10101111101101101101
10100510000000001201
10101110101110151101
10050000020300023001
10101110101110151131
10200000000500000001
11111111111111111111
