01111111111111111111
00001020301020000041
00011001110111011101
10200000000000000201
10101111001111100101
10015020003000020001
11110111101110111111
10050010021000000001
13110011101110111001
10200003020050000301
10101100001100101001
10002002500200020001
10111511100113111001
10000002000450000001
11111111111111111111
