01111111111111111111
00001002003100120101
10101010101010101010
10100010100010300101
10111015150110110101
10001000300000000001
11101110111311101111
10200500250200500021
11101110111011101111
15001000003000001001
10111011101110111001
10130010100010100001
10101010101210101001
12000020154010001021
11111111111111111111
