01111111111111111111
00001002000100120101
10101010101010101010
10100010100010100101
10111011103110110101
10001000100000000001
11131110111011101111
10200000203000000021
11101110111011101111
10001000000030001001
10111311101110111001
10100010100010100001
10101010101010101001
12001020042010201021
11111111111111111111
